[
[100,0,100,0,100,0,100,0,100,0,100,0,100,0,100,0,100,0,100,0,100],
[-1,100,-1,100,-1,100,-1,100,-1,100,-1,100,-1,100,-1,100,-1,100,-1,100,-1],
[100,-1,100,-1,100,-1,100,-1,100,-1,100,-1,100,-1,100,-1,100,-1,100,-1,100],
[-3,100,-3,100,-3,100,-3,100,-3,100,-3,100,-3,100,-3,100,-3,100,-3,100,-3],
[100,-2,100,-2,100,-2,100,-2,100,-2,100,-2,100,-2,100,-2,100,-2,100,-2,100],
[0,100,0,100,0,100,0,100,0,100,0,100,0,100,0,100,0,100,0,100,0],
[100,-3,100,-3,100,-3,100,-3,100,-3,100,-3,100,-3,100,-3,100,-3,100,-3,100],
[-2,100,-2,100,-2,100,-2,100,-2,100,-2,100,-2,100,-2,100,-2,100,-2,100,-2],
[0,100,0,100,0,100,0,100,0,100,0,100,0,100,0,100,0,100,0,100,0]
]
