[
[100,-2,-2,100,-2,100,-2,-1,0,-3,200,-3,-3,300,0,0,0,0,-3,100,-3],
[-2,100,-1,-2,100,0,-3,200,-2,0,-3,0,150,0,-2,-1,100,0,0,-3,0],
[-3,-2,-1,100,-1,0,100,-3,-2,0,0,0,-1,-2,250,-2,0,-2,150,-2,0],
[100,-3,-3,100,-2,100,-2,-2,300,-2,-2,0,0,0,-2,0,100,-3,-3,-2,0],
[100,-3,0,-3,-1,200,-1,100,-2,-2,100,-2,100,-3,0,0,-3,100,-3,-2,150],
[-3,100,0,100,-1,100,-1,100,-3,100,-2,100,-3,100,-3,100,-3,100,-3,100,0],
[150,-3,0,100,0,0,-1,200,-3,0,100,0,100,-3,100,0,100,0,100,0,100],
[-3,100,-1,100,-1,0,100,-3,-3,100,-1,100,0,0,200,-3,-3,-3,100,-2,100],
[0,0,-1,100,-1,-3,300,-3,0,-1,100,-1,0,0,-2,-2,-2,-1,400,-1,-2]
]
